//MAP CONVERTED BY dmm2tgm.py THIS HEADER COMMENT PREVENTS RECONVERSION, DO NOT REMOVE
"aq" = (
/obj/structure/chair/pew{
	dir = 1
	},
/obj/structure/window/reinforced/tinted/frosted,
/area/hilbertshotel)
"aA" = (
/obj/structure/window/reinforced/tinted/frosted{
	dir = 4
	},
/obj/structure/chair/pew,
/area/hilbertshotel)
"aY" = (
/obj/structure/table,
/obj/machinery/microwave{
	pixel_y = 6
	},
/obj/structure/window/reinforced{
	dir = 1;
	layer = 2.9
	},
/turf/open/floor/plasteel/cafeteria,
/area/hilbertshotel)
"bt" = (
/obj/effect/turf_decal/siding/wood{
	dir = 8
	},
/area/hilbertshotel)
"bI" = (
/obj/structure/sign/poster/contraband/random{
	pixel_x = 29
	},
/turf/open/floor/carpet/black,
/area/hilbertshotel)
"cH" = (
/obj/structure/table,
/obj/item/reagent_containers/food/condiment/peppermill,
/obj/item/reagent_containers/food/condiment/saltshaker{
	pixel_y = 9
	},
/obj/item/sharpener{
	pixel_x = 10
	},
/turf/open/floor/plasteel/cafeteria,
/area/hilbertshotel)
"cV" = (
/obj/machinery/shower{
	desc = "Despite their age, they seem clean and capable of providing hot water just as well as their modern counterparts. Hopefully Nanotrasen cleaned the water pipes this well...";
	dir = 4
	},
/area/hilbertshotel)
"dx" = (
/obj/structure/chair/comfy/black{
	pixel_y = 6;
	dir = 8
	},
/turf/open/floor/carpet/royalblack,
/area/hilbertshotel)
"dQ" = (
/obj/machinery/telecomms/relay/preset/auto,
/area/hilbertshotel)
"eH" = (
/obj/structure/mineral_door/transparent,
/turf/open/floor/pod/dark,
/area/hilbertshotel)
"fq" = (
/turf/open/floor/carpet/red,
/area/hilbertshotel)
"fr" = (
/obj/structure/fans/tiny/invisible,
/area/hilbertshotel)
"fs" = (
/obj/structure/sign/poster/contraband/random{
	pixel_x = -31
	},
/area/hilbertshotel)
"fB" = (
/obj/machinery/light{
	dir = 4
	},
/turf/open/floor/plasteel/cafeteria,
/area/hilbertshotel)
"gj" = (
/obj/structure/mineral_door/wood,
/area/hilbertshotel)
"id" = (
/obj/structure/table,
/turf/open/floor/pod/light,
/area/hilbertshotel)
"ix" = (
/obj/effect/turf_decal/siding/wood{
	dir = 6
	},
/turf/open/floor/carpet/royalblue,
/area/hilbertshotel)
"jC" = (
/obj/structure/falsewall,
/turf/open/floor/pod/light,
/area/hilbertshotel)
"kg" = (
/obj/structure/closet/crate/bin,
/turf/open/floor/carpet/red,
/area/hilbertshotel)
"ki" = (
/obj/structure/fireplace{
	dir = 8
	},
/area/hilbertshotel)
"kz" = (
/turf/open/floor/pod/dark,
/area/hilbertshotel)
"lq" = (
/turf/open/floor/plasteel/cafeteria,
/area/hilbertshotel)
"lR" = (
/obj/structure/chair/sofa/corp/right{
	dir = 1
	},
/area/hilbertshotel)
"md" = (
/obj/machinery/light{
	dir = 8
	},
/obj/effect/decal/cleanable/ash,
/turf/open/floor/carpet/black,
/area/hilbertshotel)
"nA" = (
/obj/structure/window/reinforced/tinted/frosted,
/obj/structure/reagent_dispensers/watertank,
/area/hilbertshotel)
"nF" = (
/turf/open/floor/carpet/black,
/area/hilbertshotel)
"nH" = (
/obj/machinery/light{
	dir = 4
	},
/area/hilbertshotel)
"oa" = (
/obj/machinery/light/floor{
	bulb_colour = "#F27D0C"
	},
/area/hilbertshotel)
"pu" = (
/obj/structure/showcase/machinery/tv,
/obj/structure/table,
/area/hilbertshotel)
"pH" = (
/turf/open/floor/carpet/royalblue,
/area/hilbertshotel)
"rj" = (
/obj/machinery/light{
	dir = 1
	},
/obj/effect/turf_decal/siding{
	dir = 4
	},
/area/hilbertshotel)
"rk" = (
/obj/structure/chair/sofa/corp{
	dir = 1
	},
/area/hilbertshotel)
"ry" = (
/obj/structure/closet/cabinet{
	pixel_x = -6
	},
/turf/open/floor/carpet/royalblack,
/area/hilbertshotel)
"sr" = (
/turf/closed/wall,
/area/hilbertshotel)
"sV" = (
/obj/machinery/vending/dinnerware{
	contraband = list(/obj/item/kitchen/rollingpin=2,/obj/item/kitchen/knife/butcher=2,/obj/item/reagent_containers/food/condiment/flour=4);
	shut_up = 1
	},
/turf/open/floor/plasteel/cafeteria,
/area/hilbertshotel)
"tm" = (
/obj/effect/turf_decal/siding/wood{
	dir = 1
	},
/turf/open/floor/carpet/royalblue,
/area/hilbertshotel)
"tA" = (
/obj/effect/turf_decal/siding/wood{
	dir = 9
	},
/turf/open/floor/carpet/royalblue,
/area/hilbertshotel)
"tQ" = (
/obj/structure/closet/cabinet,
/area/hilbertshotel)
"tR" = (
/obj/machinery/door/morgue,
/area/hilbertshotel)
"vv" = (
/obj/structure/closet/crate/wooden,
/obj/item/stack/sheet/mineral/wood/fifty,
/area/hilbertshotel)
"vP" = (
/obj/structure/chair/sofa/corp{
	dir = 4
	},
/area/hilbertshotel)
"vZ" = (
/obj/machinery/smartfridge/food,
/area/hilbertshotel)
"ww" = (
/obj/structure/chair/pew/left,
/area/hilbertshotel)
"xn" = (
/obj/structure/chair{
	dir = 4
	},
/turf/open/floor/pod/light,
/area/hilbertshotel)
"xp" = (
/obj/structure/window/reinforced{
	dir = 8
	},
/area/hilbertshotel)
"xt" = (
/obj/structure/lattice,
/turf/open/space/bluespace,
/area/hilbertshotel)
"yc" = (
/obj/structure/table,
/obj/effect/turf_decal/siding/wood{
	dir = 8
	},
/obj/item/storage/fancy/heart_box,
/obj/item/paper/fluff/hilbertshotel/welcomeletter,
/turf/open/floor/carpet/royalblue,
/area/hilbertshotel)
"yJ" = (
/obj/structure/window/reinforced/tinted/frosted{
	dir = 4
	},
/obj/structure/chair/pew{
	dir = 1
	},
/obj/structure/window/reinforced/tinted/frosted,
/area/hilbertshotel)
"Am" = (
/obj/machinery/button{
	pixel_y = 26;
	id = "elevator"
	},
/obj/machinery/button{
	pixel_y = 37;
	id = "elevator"
	},
/obj/structure/extinguisher_cabinet{
	pixel_x = 30
	},
/turf/open/floor/carpet/black,
/area/hilbertshotel)
"Au" = (
/obj/structure/sink/kitchen{
	dir = 8;
	pixel_x = 11
	},
/turf/open/floor/plasteel/cafeteria,
/area/hilbertshotel)
"Cf" = (
/obj/effect/turf_decal/siding/wood,
/turf/open/floor/carpet/royalblue,
/area/hilbertshotel)
"CD" = (
/turf/open/floor/pod/light,
/area/hilbertshotel)
"DR" = (
/obj/structure/table,
/obj/effect/spawner/lootdrop/three_course_meal,
/obj/machinery/reagentgrinder{
	pixel_y = 8
	},
/turf/open/floor/plasteel/cafeteria,
/area/hilbertshotel)
"Ex" = (
/turf/closed/indestructible/hoteldoor{
	icon_state = "door_closed";
	icon = 'icons/obj/doors/puzzledoor/default.dmi'
	},
/area/hilbertshotel)
"EB" = (
/obj/machinery/light{
	bulb_colour = "FFB43A"
	},
/area/hilbertshotel)
"EV" = (
/obj/machinery/light{
	dir = 1
	},
/obj/structure/closet/crate/wooden,
/obj/item/stack/sheet/mineral/wood/fifty,
/area/hilbertshotel)
"Fh" = (
/obj/structure/closet/crate,
/obj/item/stack/sheet/mineral/wood/fifty,
/obj/item/reagent_containers/glass/bucket{
	pixel_y = 7
	},
/area/hilbertshotel)
"Fi" = (
/turf/open/floor/carpet/royalblack,
/area/hilbertshotel)
"Ft" = (
/obj/structure/toilet{
	dir = 4
	},
/obj/machinery/light/floor,
/area/hilbertshotel)
"Gi" = (
/obj/structure/bedsheetbin/towel,
/obj/structure/table,
/obj/machinery/light{
	dir = 1;
	bulb_colour = "FFB43A"
	},
/area/hilbertshotel)
"Gk" = (
/obj/structure/table,
/obj/effect/turf_decal/siding/wood{
	dir = 10
	},
/turf/open/floor/carpet/royalblue,
/area/hilbertshotel)
"Hp" = (
/obj/structure/bookcase/random,
/turf/open/floor/carpet/royalblack,
/area/hilbertshotel)
"HZ" = (
/obj/structure/table,
/obj/item/electropack/shockcollar,
/obj/effect/decal/cleanable/cobweb,
/turf/open/floor/pod/light,
/area/hilbertshotel)
"IJ" = (
/obj/item/kirbyplants/random,
/area/hilbertshotel)
"IV" = (
/obj/structure/window/reinforced{
	dir = 4;
	layer = 2.9
	},
/obj/structure/window/reinforced,
/obj/structure/window/reinforced{
	dir = 1;
	layer = 2.9
	},
/obj/structure/window/reinforced{
	dir = 8
	},
/obj/structure/flora/junglebush,
/area/hilbertshotel)
"Jk" = (
/obj/machinery/vending/coffee{
	shut_up = 1
	},
/turf/open/floor/carpet/black,
/area/hilbertshotel)
"Jy" = (
/obj/structure/bed/double,
/turf/open/floor/carpet/royalblack,
/area/hilbertshotel)
"JK" = (
/obj/machinery/vending/boozeomat{
	onstation = 0;
	shut_up = 1
	},
/area/hilbertshotel)
"Lp" = (
/obj/item/newspaper{
	pixel_x = 4
	},
/turf/open/floor/carpet{
	icon_state = "carpetsymbol";
	dir = 1
	},
/area/hilbertshotel)
"Mo" = (
/area/hilbertshotel)
"MJ" = (
/obj/structure/table,
/obj/item/reagent_containers/syringe{
	pixel_x = -5;
	pixel_y = 14
	},
/turf/open/floor/pod/light,
/area/hilbertshotel)
"MR" = (
/obj/structure/sign/poster/contraband/random{
	pixel_x = 29
	},
/turf/open/floor/plasteel/cafeteria,
/area/hilbertshotel)
"Oc" = (
/obj/machinery/vending/kink{
	onstation = 0;
	shut_up = 1
	},
/obj/machinery/light{
	dir = 8;
	color = "#fc2847"
	},
/turf/open/floor/pod/light,
/area/hilbertshotel)
"Of" = (
/obj/structure/window/reinforced{
	dir = 8;
	layer = 2.9
	},
/obj/item/reagent_containers/food/drinks/beer,
/obj/item/reagent_containers/food/drinks/beer,
/obj/item/reagent_containers/food/drinks/beer,
/obj/item/reagent_containers/food/drinks/beer,
/obj/item/reagent_containers/food/drinks/beer,
/obj/item/reagent_containers/food/drinks/beer,
/obj/item/reagent_containers/food/condiment/flour,
/obj/structure/closet/secure_closet/freezer/fridge,
/turf/open/floor/plasteel/cafeteria,
/area/hilbertshotel)
"OE" = (
/obj/machinery/light{
	dir = 1
	},
/turf/open/floor/pod/dark,
/area/hilbertshotel)
"ON" = (
/obj/effect/turf_decal/siding/wood{
	dir = 5
	},
/turf/open/floor/carpet/royalblue,
/area/hilbertshotel)
"OY" = (
/obj/machinery/jukebox{
	req_one_access = null;
	area_limited = 1
	},
/obj/machinery/light{
	dir = 1
	},
/area/hilbertshotel)
"PE" = (
/obj/structure/closet/crate/bin{
	pixel_x = -6
	},
/turf/open/floor/carpet/royalblack,
/area/hilbertshotel)
"PP" = (
/obj/machinery/button{
	pixel_y = -25;
	id = "elevator"
	},
/obj/machinery/button{
	pixel_y = -35;
	id = "elevator"
	},
/turf/open/floor/pod/dark,
/area/hilbertshotel)
"Ql" = (
/obj/structure/chair/sofa/corp/left{
	dir = 4
	},
/area/hilbertshotel)
"Qt" = (
/obj/machinery/light,
/turf/open/floor/carpet/royalblack,
/area/hilbertshotel)
"Rb" = (
/obj/item/pizzabox/margherita{
	pixel_y = 11
	},
/obj/effect/turf_decal/siding/wood,
/obj/structure/table,
/turf/open/floor/carpet/royalblue,
/area/hilbertshotel)
"RP" = (
/obj/machinery/vending/cigarette{
	shut_up = 1
	},
/turf/open/floor/carpet/black,
/area/hilbertshotel)
"Si" = (
/obj/structure/dresser,
/turf/open/floor/carpet/royalblack,
/area/hilbertshotel)
"Sx" = (
/obj/structure/table/wood,
/obj/item/flashlight/lamp/green{
	pixel_x = 5;
	pixel_y = 14
	},
/turf/open/floor/carpet/royalblack,
/area/hilbertshotel)
"SG" = (
/obj/structure/table/wood,
/obj/item/choice_beacon/box/plushie,
/turf/open/floor/carpet/royalblack,
/area/hilbertshotel)
"SH" = (
/obj/item/kirbyplants/random,
/turf/open/floor/carpet/black,
/area/hilbertshotel)
"SZ" = (
/obj/structure/closet/crate/bin{
	pixel_x = 9
	},
/turf/open/floor/carpet/black,
/area/hilbertshotel)
"Ti" = (
/obj/structure/window/reinforced,
/obj/structure/window/reinforced{
	dir = 4
	},
/obj/structure/window/reinforced{
	dir = 1;
	layer = 2.9
	},
/obj/structure/flora/junglebush/large{
	pixel_y = -1
	},
/area/hilbertshotel)
"Tw" = (
/obj/structure/chair/comfy/black{
	pixel_y = 6;
	dir = 1
	},
/obj/machinery/light,
/obj/effect/turf_decal/siding{
	dir = 4
	},
/area/hilbertshotel)
"TE" = (
/obj/structure/closet/crate/bin{
	pixel_x = -6
	},
/obj/structure/sign/poster/contraband/random{
	pixel_x = -31
	},
/area/hilbertshotel)
"TU" = (
/obj/structure/table,
/obj/item/lighter/gold,
/turf/open/floor/carpet/royalblue,
/area/hilbertshotel)
"Uh" = (
/obj/structure/chair/sofa/corp/corner{
	dir = 1
	},
/obj/machinery/light,
/area/hilbertshotel)
"Ul" = (
/obj/effect/turf_decal/siding{
	dir = 4
	},
/area/hilbertshotel)
"Vi" = (
/obj/effect/turf_decal/siding/wood{
	dir = 8
	},
/obj/structure/closet/crate/wooden,
/obj/item/clothing/shoes/sandal,
/obj/item/clothing/shoes/sandal,
/obj/item/clothing/shoes/sandal,
/obj/item/clothing/shoes/sandal,
/obj/item/clothing/shoes/sandal,
/obj/item/clothing/shoes/sandal,
/obj/item/clothing/shoes/sandal,
/area/hilbertshotel)
"VY" = (
/obj/structure/table,
/obj/item/reagent_containers/blood/BPlus{
	pixel_x = 9
	},
/obj/item/reagent_containers/blood/BPlus{
	pixel_x = 9
	},
/obj/item/reagent_containers/blood/BPlus{
	pixel_x = 9
	},
/turf/open/floor/pod/light,
/area/hilbertshotel)
"Wp" = (
/obj/machinery/light{
	dir = 8
	},
/obj/machinery/vending/games{
	shut_up = 1
	},
/turf/open/floor/carpet/black,
/area/hilbertshotel)
"Wy" = (
/obj/effect/turf_decal/siding/wood{
	dir = 4
	},
/turf/open/floor/carpet/royalblue,
/area/hilbertshotel)
"XI" = (
/obj/structure/rack,
/turf/open/floor/carpet/red,
/area/hilbertshotel)
"Ym" = (
/obj/machinery/computer{
	dir = 4;
	pixel_x = -3
	},
/turf/open/floor/carpet/royalblack,
/area/hilbertshotel)
"ZG" = (
/obj/machinery/light{
	dir = 1
	},
/area/hilbertshotel)

(1,1,1) = {"
Mo
Mo
Mo
Mo
Mo
Ex
Mo
Mo
Mo
Mo
Mo
Mo
Mo
Mo
Mo
Mo
"}
(2,1,1) = {"
Mo
HZ
xn
Oc
sr
kz
kz
PP
sr
SH
md
RP
Jk
Wp
SH
Mo
"}
(3,1,1) = {"
Mo
MJ
CD
id
sr
OE
kz
kz
eH
nF
nF
nF
nF
nF
nF
Mo
"}
(4,1,1) = {"
Mo
id
CD
VY
sr
kz
kz
kz
sr
Am
bI
SZ
Lp
nF
bI
Mo
"}
(5,1,1) = {"
Mo
sr
jC
sr
sr
sr
sr
sr
sr
Mo
Mo
sr
gj
sr
Mo
Mo
"}
(6,1,1) = {"
Mo
Ym
ry
PE
sr
IJ
fs
Ql
vP
Uh
Mo
XI
fq
kg
Mo
dQ
"}
(7,1,1) = {"
Mo
dx
Fi
Qt
sr
ZG
tA
yc
Gk
rk
Mo
Vi
bt
bt
Mo
xt
"}
(8,1,1) = {"
Mo
Si
Fi
Fi
gj
Mo
tm
TU
Rb
lR
Mo
EV
Mo
Mo
Mo
xt
"}
(9,1,1) = {"
Mo
Hp
Fi
Fi
sr
pu
tm
pH
Cf
Mo
Mo
IJ
Mo
tQ
Mo
xt
"}
(10,1,1) = {"
Mo
Sx
Jy
SG
sr
OY
ON
Wy
ix
Mo
Mo
sr
gj
sr
Mo
xt
"}
(11,1,1) = {"
Mo
sr
sr
sr
sr
sr
vv
ki
Mo
Mo
Ti
TE
Mo
Mo
Mo
Mo
"}
(12,1,1) = {"
Mo
Mo
Fh
nA
cV
sr
sr
sr
Mo
Mo
Mo
Mo
Mo
Mo
IJ
Mo
"}
(13,1,1) = {"
Mo
ww
oa
aq
EB
sr
Ft
sr
rj
Ul
Ul
Ul
Ul
Ul
Tw
Mo
"}
(14,1,1) = {"
Mo
aA
Mo
yJ
Mo
sr
tR
sr
Mo
xp
IV
DR
cH
lq
Of
Mo
"}
(15,1,1) = {"
Mo
Gi
fr
Mo
Mo
tR
Mo
Mo
nH
Mo
aY
Au
fB
MR
sV
Mo
"}
(16,1,1) = {"
Mo
Mo
Mo
Mo
Mo
Mo
Mo
Mo
Mo
Mo
Mo
JK
vZ
Mo
Mo
Mo
"}
